111111
1E1C01
11P001
10C001
111111