111111
10ECP1
100001
111111
111111
111111