11111111111
1P0E0000001
10111111101
101C0000001
10001111101
11111000001
1C0C1011111
1101101C001
1L0C0011101
10001000001
11111111111