111111
1C1C01
11P001
10E001
111111