111111
10E0C1
1J0001
1PC001
100CC1
111111